1,1,1,1,1,1,1,1,1,1,1,1,1,1,1,1,1,1,1,1,1
1,0,0,4,1,0,0,0,0,0,0,0,0,1,5,0,0,0,0,0,1
1,0,0,0,1,0,1,1,1,0,1,1,0,1,0,0,0,0,0,0,1
1,0,0,0,1,0,1,2,0,8,0,1,0,1,0,0,0,0,0,0,1
1,0,0,0,1,0,1,1,1,1,1,1,0,1,0,0,0,0,0,0,1
1,0,0,0,1,0,1,0,7,0,3,1,0,1,0,0,0,0,0,0,1
1,0,0,0,1,0,1,1,0,1,1,1,0,1,0,0,0,0,0,0,1
1,0,0,0,1,0,0,0,0,0,0,0,0,1,0,0,0,0,0,0,1
1,0,0,0,1,1,6,6,6,6,6,6,1,1,0,0,0,0,0,0,1
1,0,0,0,6,6,6,6,6,6,6,6,6,6,0,0,0,0,0,0,1
1,6,6,6,6,6,6,6,6,6,6,6,6,6,6,6,6,0,0,0,1
1,1,1,1,1,1,1,1,1,1,1,1,1,1,1,1,1,1,1,1,1
