1,1,1,1,1,1,1,1,1,1,1,1,1,1,1,1,1,1,1,1,1
1,2,0,8,4,1,4,0,0,6,0,6,4,6,0,0,0,0,8,0,1
1,1,1,0,1,1,0,1,1,1,0,1,6,1,0,0,0,1,1,1,1
1,0,6,0,6,1,6,1,0,0,0,1,0,1,0,0,0,0,1,1,1
1,0,0,0,0,0,0,0,0,0,0,0,0,0,0,0,1,6,0,0,1
1,6,0,0,1,0,0,0,0,6,6,6,0,0,0,6,1,0,0,0,1
1,0,0,0,1,6,0,0,0,6,6,6,0,0,0,0,1,0,0,6,1
1,0,0,6,1,0,0,0,0,0,0,0,0,0,0,0,0,0,0,0,1
1,1,6,0,0,0,0,1,6,1,0,0,0,1,6,1,6,0,6,0,1
1,4,0,7,0,0,0,6,0,6,0,1,1,1,0,1,1,0,1,1,1
1,1,1,1,0,0,0,1,5,1,0,6,0,0,4,1,0,6,0,3,1
1,1,1,1,1,1,1,1,1,1,1,1,1,1,1,1,1,1,1,1,1
